X,X,X,X,X,X,X,SP,X
X,X,X,X,X,X,X,.P,X
X,X,X,X,X,X,.P,.P,X
X,X,X,X,X,.P,.P,X,X
X,X,X,X,.P,.P,X,X,X
X,X,X,X,.P,X,X,X,X
X,X,X,X,.P,X,X,X,X
X,X,X,X,.P,X,X,X,X
X,X,X,X,.P,X,X,X,X
X,X,X,X,EP,X,X,X,X